23 43
@ @ @ @ @ @ @ @ @ @ @ @ @ @ @ @ @ @ @ @ @ @ @ @ @ @ @ @ @ @ @ @ @ @ @ @ @ @ @ @ @ @ @
@ . . . . . . @ @ @ @ @ @ @ @ @ @ @ @ . . . . . . . @ @ @ @ @ @ @ @ @ @ @ . . . . . @
@ . . . . . . @ @ @ @ @ @ @ @ @ @ @ @ . . . . . . . @ @ @ @ @ @ @ @ @ @ @ . . . . . @
@ . . . . . . @ @ @ @ @ @ @ @ @ @ @ @ . . . . . . . @ @ @ @ @ @ @ @ @ @ @ . . . . . @
@ . . . . . . . . . . . . . . . . . . . . . . . . . . . . . . . . . . . . . . . . . @
@ . . . . . . . . . . . . . . . . . . . . . . . . . . . . . . . . . . . . . . . . . @
@ . @ @ @ . @ @ @ . @ @ @ . @ @ @ . @ @ @ . @ @ @ . @ @ @ . @ @ @ . @ @ @ . @ @ @ . @
@ . @ @ @ . @ @ @ . @ @ @ . @ @ @ . @ @ @ . @ @ @ . @ @ @ . @ @ @ . @ @ @ . @ @ @ . @
@ . @ @ @ . @ @ @ . @ @ @ . @ @ @ . @ @ @ . @ @ @ . @ @ @ . @ @ @ . @ @ @ . @ @ @ . @
@ . @ @ @ . @ @ @ . @ @ @ . @ @ @ . @ @ @ . @ @ @ . @ @ @ . @ @ @ . @ @ @ . @ @ @ . @
@ . @ @ @ . @ @ @ . @ @ @ . @ @ @ . @ @ @ . @ @ @ . @ @ @ . @ @ @ . @ @ @ . @ @ @ . @
@ . @ @ @ . @ @ @ . @ @ @ . @ @ @ . @ @ @ . @ @ @ . @ @ @ . @ @ @ . @ @ @ . @ @ @ . @
@ . . . . . . . . . . . . . . . . . . . . . . . . . . . . . . . . . . . . . . . . . @
@ . . . . . . . . . . . . . . . . . . . . . . . . . . . . . . . . . . . . . . . . . @
@ . . . @ @ @ @ @ @ @ @ @ @ @ @ @ @ @ @ @ @ @ @ @ @ @ @ @ @ @ @ @ @ @ @ @ @ @ @ . . @
@ . . . @ @ @ @ @ @ @ @ @ @ @ @ @ @ @ @ @ @ @ @ @ @ @ @ @ @ @ @ @ @ @ @ @ @ @ @ . . @
@ . . . @ @ @ @ @ @ @ @ @ @ @ @ @ @ @ @ @ @ @ @ @ @ @ @ @ @ @ @ @ @ @ @ @ @ @ @ . . @
@ . . . . . . . . . . . . . . . . . . . . . . . . . . . . . . . . . . . . . . . . . @
@ . . . . . . . . . . . . . . . . . . . . . . . . . . . . . . . . . . . . . . . . . @
@ . . @ . . @ @ . . @ @ . . @ @ . . @ @ . . @ @ . . @ @ . . @ @ . . @ @ . . @ @ . . @
@ . . @ . . @ @ . . @ @ . . @ @ . . @ @ . . @ @ . . @ @ . . @ @ . . @ @ . . @ @ . . @
@ . . @ . . @ @ . . @ @ . . @ @ . . @ @ . . @ @ . . @ @ . . @ @ . . @ @ . . @ @ . . @
@ @ @ @ @ @ @ @ @ @ @ @ @ @ @ @ @ @ @ @ @ @ @ @ @ @ @ @ @ @ @ @ @ @ @ @ @ @ @ @ @ @ @
11
21 40 12 37
21 4 6 5
21 8 6 25
21 12 1 19
21 16 10 13
21 20 10 41
21 24 9 33
21 28 13 5
21 32 13 21
21 36 1 6
21 1 12 13